norandom
11
8
###########
# #       #
# #       #
# #    a  #
# w       #
# #       #
# #       #
###########