norandom
11
8
###########
#         #
#         #
#       # #
#        o#
#      a ##
#     # w #
###########