norandom
11
8
###########
#         #
#####w#####
#  ## ##  #
#  ## ##  #
#         #
#    a    #
###########