norandom
8
10
########
#      #
#      #
# a    #
#      #
#      #
#      #
###w####
#      #
########