norandom
8
10
########
#  a   #
#      #
#  #   #
#  #o  #
#   o  #
# ##   #
#      #
#      #
########