norandom
6
6
######
# # o#
# a  #
#   ##
#   ##
######
