norandom
10
10
##########
#        #
#     ####
#       *#
###o   o##
#        #
#        #
# w      #
#a       #
##########
